1111111111
1000100001
1000100001
1011100101
1000000001
1111110101
1000000001
1000000111
1000000101
1010000101
1010000001
1010000001
101000$001
1010000001
1111111111